ang	Chinese
auyong	Chinese
bai	Chinese
ban	Chinese
bao	Chinese
bei	Chinese
bian	Chinese
bui	Chinese
cai	Chinese
cao	Chinese
cen	Chinese
chai	Chinese
chaim	Chinese
chan	Chinese
chang	Chinese
chao	Chinese
che	Chinese
chen	Chinese
cheng	Chinese
cheung	Chinese
chew	Chinese
chieu	Chinese
chin	Chinese
chong	Chinese
chou	Chinese
chu	Chinese
cui	Chinese
dai	Chinese
deng	Chinese
ding	Chinese
dong	Chinese
dou	Chinese
duan	Chinese
eng	Chinese
fan	Chinese
fei	Chinese
feng	Chinese
foong	Chinese
fung	Chinese
gan	Chinese
gauk	Chinese
geng	Chinese
gim	Chinese
gok	Chinese
gong	Chinese
guan	Chinese
guang	Chinese
guo	Chinese
gwock	Chinese
han	Chinese
hang	Chinese
hao	Chinese
hew	Chinese
hiu	Chinese
hong	Chinese
hor	Chinese
hsiao	Chinese
hua	Chinese
huan	Chinese
huang	Chinese
hui	Chinese
huie	Chinese
huo	Chinese
jia	Chinese
jiang	Chinese
jin	Chinese
jing	Chinese
joe	Chinese
kang	Chinese
kau	Chinese
khoo	Chinese
khu	Chinese
kong	Chinese
koo	Chinese
kwan	Chinese
kwei	Chinese
kwong	Chinese
lai	Chinese
lam	Chinese
lang	Chinese
lau	Chinese
law	Chinese
lew	Chinese
lian	Chinese
liao	Chinese
lim	Chinese
lin	Chinese
ling	Chinese
liu	Chinese
loh	Chinese
long	Chinese
loong	Chinese
luo	Chinese
mah	Chinese
mai	Chinese
mak	Chinese
mao	Chinese
mar	Chinese
mei	Chinese
meng	Chinese
miao	Chinese
min	Chinese
ming	Chinese
moy	Chinese
mui	Chinese
nie	Chinese
niu	Chinese
ouyang	Chinese
owyang	Chinese
pan	Chinese
pang	Chinese
pei	Chinese
peng	Chinese
ping	Chinese
qian	Chinese
qin	Chinese
qiu	Chinese
quan	Chinese
que	Chinese
ran	Chinese
rao	Chinese
rong	Chinese
ruan	Chinese
sam	Chinese
seah	Chinese
see	Chinese
seow	Chinese
seto	Chinese
sha	Chinese
shan	Chinese
shang	Chinese
shao	Chinese
shaw	Chinese
she	Chinese
shen	Chinese
sheng	Chinese
shi	Chinese
shu	Chinese
shuai	Chinese
shui	Chinese
shum	Chinese
siew	Chinese
siu	Chinese
song	Chinese
sum	Chinese
sun	Chinese
sze	Chinese
tan	Chinese
tang	Chinese
tao	Chinese
teng	Chinese
teoh	Chinese
thean	Chinese
thian	Chinese
thien	Chinese
tian	Chinese
tong	Chinese
tow	Chinese
tsang	Chinese
tse	Chinese
tsen	Chinese
tso	Chinese
tze	Chinese
wan	Chinese
wang	Chinese
wei	Chinese
wen	Chinese
weng	Chinese
won	Chinese
wong	Chinese
woo	Chinese
xiang	Chinese
xiao	Chinese
xie	Chinese
xing	Chinese
xue	Chinese
xun	Chinese
yan	Chinese
yang	Chinese
yao	Chinese
yap	Chinese
yau	Chinese
yee	Chinese
yep	Chinese
yim	Chinese
yin	Chinese
ying	Chinese
yong	Chinese
you	Chinese
yuan	Chinese
zang	Chinese
zeng	Chinese
zha	Chinese
zhan	Chinese
zhang	Chinese
zhao	Chinese
zhen	Chinese
zheng	Chinese
zhong	Chinese
zhou	Chinese
zhu	Chinese
zhuo	Chinese
zong	Chinese
zou	Chinese
bing	Chinese
chi	Chinese
cong	Chinese
cuan	Chinese
dan	Chinese
gai	Chinese
gao	Chinese
gou	Chinese
gui	Chinese
hou	Chinese
jian	Chinese
jiao	Chinese
jiu	Chinese
juan	Chinese
jue	Chinese
kan	Chinese
kuai	Chinese
kuang	Chinese
kui	Chinese
lao	Chinese
liang	Chinese
lu	Chinese
man	Chinese
nao	Chinese
pian	Chinese
qiao	Chinese
qing	Chinese
rang	Chinese
rui	Chinese
shuo	Chinese
sui	Chinese
tai	Chinese
xian	Chinese
xin	Chinese
xiong	Chinese
xuan	Chinese
yue	Chinese
yun	Chinese
zhai	Chinese
zhi	Chinese
zhuan	Chinese
zhui	Chinese
abl	Czech
adsit	Czech
ajdrna	Czech
alt	Czech
antonowitsch	Czech
antonowitz	Czech
bacon	Czech
ballalatak	Czech
ballaltick	Czech
bartonova	Czech
bastl	Czech
baroch	Czech
benesch	Czech
betlach	Czech
biganska	Czech
bilek	Czech
blahut	Czech
blazek	Czech
blazejovsky	Czech
blecha	Czech
bleskan	Czech
blober	Czech
bock	Czech
bohac	Czech
bohunovsky	Czech
bolcar	Czech
borovka	Czech
borovski	Czech
borowski	Czech
borovsky	Czech
brabbery	Czech
brezovjak	Czech
brousil	Czech
bruckner	Czech
buchta	Czech
cablikova	Czech
camfrlova	Czech
cap	Czech
cerda	Czech
cermak	Czech
chermak	Czech
cernochova	Czech
cernohous	Czech
cerny	Czech
cerney	Czech
cerv	Czech
cervenka	Czech
chalupka	Czech
charlott	Czech
chemlik	Czech
chicken	Czech
chilar	Czech
chromy	Czech
cihak	Czech
clineburg	Czech
klineberg	Czech
cober	Czech
colling	Czech
cvacek	Czech
czabal	Czech
damell	Czech
demall	Czech
dehmel	Czech
dana	Czech
dejmal	Czech
dempko	Czech
demko	Czech
dinko	Czech
divoky	Czech
dolejsi	Czech
dolezal	Czech
doljs	Czech
dopita	Czech
drassal	Czech
driml	Czech
duyava	Czech
dvorak	Czech
dziadik	Czech
egr	Czech
entler	Czech
faltysek	Czech
faltejsek	Czech
fencl	Czech
fenyo	Czech
fillipova	Czech
finfera	Czech
finferovy	Czech
finke	Czech
fojtikova	Czech
fremut	Czech
friedrich	Czech
frierdich	Czech
fritsch	Czech
furtsch	Czech
gabrisova	Czech
gavalok	Czech
geier	Czech
georgijev	Czech
geryk	Czech
giersig	Czech
glatter	Czech
glockl	Czech
grabski	Czech
grozmanova	Czech
grulich	Czech
grygarova	Czech
hadash	Czech
hafernik	Czech
hajek	Czech
hajicek	Czech
hajkova	Czech
hana	Czech
hanek	Czech
hanika	Czech
hanusch	Czech
hanzlick	Czech
handzlik	Czech
hanzlik	Czech
harger	Czech
hartl	Czech
havlatova	Czech
havlice	Czech
hawlata	Czech
heidl	Czech
herback	Czech
herodes	Czech
hiorvst	Czech
hladky	Czech
hlavsa	Czech
hnizdil	Czech
hodowal	Czech
hodoval	Czech
holan	Czech
holub	Czech
homulka	Czech
hora	Czech
hovanec	Czech
hrabak	Czech
hradek	Czech
hrdy	Czech
hrula	Czech
hruska	Czech
hruskova	Czech
hudecek	Czech
husk	Czech
hynna	Czech
jaluvka	Czech
janca	Czech
janicek	Czech
jenicek	Czech
janacek	Czech
janick	Czech
janoch	Czech
janosik	Czech
janutka	Czech
jares	Czech
jarzembowski	Czech
jedlicka	Czech
jelinek	Czech
jindra	Czech
jirava	Czech
jirik	Czech
jirku	Czech
jirovy	Czech
jobst	Czech
jonas	Czech
kacirek	Czech
kafka	Czech
kaiser	Czech
kanak	Czech
kaplanek	Czech
kara	Czech
karlovsky	Czech
kasa	Czech
kasimor	Czech
kazimor	Czech
kazmier	Czech
katschker	Czech
kauphsman	Czech
kenzel	Czech
kerner	Czech
kesl	Czech
kessel	Czech
kessler	Czech
khork	Czech
kirchma	Czech
klein	Czech
klemper	Czech
klimes	Czech
kober	Czech
koberna	Czech
koci	Czech
kocian	Czech
kofron	Czech
kolacny	Czech
koliha	Czech
kolman	Czech
koma	Czech
komo	Czech
coma	Czech
konarik	Czech
kopp	Czech
kopecky	Czech
korandak	Czech
korycan	Czech
korycansky	Czech
kosko	Czech
kouba	Czech
koukal	Czech
koza	Czech
kozumplikova	Czech
kratschmar	Czech
krawiec	Czech
kreisinger	Czech
kremlacek	Czech
kremlicka	Czech
kreutschmer	Czech
krhovsky	Czech
krivan	Czech
krivolavy	Czech
kriz	Czech
kruessel	Czech
krupala	Czech
krytinar	Czech
kubin	Czech
kucera	Czech
kucharova	Czech
kudrna	Czech
kuffel	Czech
kupfel	Czech
kofel	Czech
kulhanek	Czech
kunik	Czech
kurtz	Czech
kusak	Czech
kvasnicka	Czech
lawa	Czech
linart	Czech
lind	Czech
lokay	Czech
loskot	Czech
ludwig	Czech
lynsmeier	Czech
macha	Czech
machacek	Czech
macikova	Czech
malafa	Czech
malec	Czech
malecha	Czech
maly	Czech
marek	Czech
marik	Czech
markytan	Czech
matejka	Czech
matjeka	Czech
matocha	Czech
maxab	Czech
mayer	Czech
meier	Czech
merta	Czech
meszes	Czech
metjeka	Czech
michalovic	Czech
michalovicova	Czech
miksatkova	Czech
mojzis	Czech
mojjis	Czech
mozzis	Czech
molcan	Czech
monfort	Czech
monkoaustria	Czech
morava	Czech
morek	Czech
muchalon	Czech
mudra	Czech
muhlbauer	Czech
nadvornizch	Czech
nadwornik	Czech
navara	Czech
navratil	Czech
navrkal	Czech
nekuza	Czech
nemec	Czech
nemecek	Czech
nestrojil	Czech
netsch	Czech
neusser	Czech
neisser	Czech
naizer	Czech
novak	Czech
nowak	Czech
novotny	Czech
novynovy	Czech
oborny	Czech
ocasek	Czech
ocaskova	Czech
oesterreicher	Czech
okenfuss	Czech
olbrich	Czech
ondrisek	Czech
opizka	Czech
opova	Czech
opp	Czech
osladil	Czech
ozimuk	Czech
pachr	Czech
palzewicz	Czech
panek	Czech
patril	Czech
pavlik	Czech
pavlicka	Czech
pavlu	Czech
pawlak	Czech
pear	Czech
peary	Czech
pech	Czech
peisar	Czech
paisar	Czech
paiser	Czech
perevuznik	Czech
perina	Czech
persein	Czech
petrezelka	Czech
petru	Czech
pesek	Czech
petersen	Czech
pfeifer	Czech
picha	Czech
pillar	Czech
pellar	Czech
piller	Czech
pinter	Czech
pitterman	Czech
planick	Czech
piskach	Czech
plisek	Czech
plisko	Czech
pokorny	Czech
ponec	Czech
prachar	Czech
praseta	Czech
prchal	Czech
prehatney	Czech
pretsch	Czech
prill	Czech
psik	Czech
pudel	Czech
purdes	Czech
quasninsky	Czech
raffel	Czech
rafaj	Czech
ransom	Czech
rezac	Czech
riedel	Czech
riha	Czech
ritchie	Czech
rozinek	Czech
ruba	Czech
ruda	Czech
rumisek	Czech
ruzicka	Czech
rypka	Czech
rebka	Czech
rzehak	Czech
sabol	Czech
safko	Czech
samz	Czech
sankovsky	Czech
sappe	Czech
sarna	Czech
satorie	Czech
savchak	Czech
svotak	Czech
swatchak	Czech
svocak	Czech
svotchak	Czech
schallom	Czech
schenk	Czech
schlantz	Czech
schmeiser	Czech
schneider	Czech
schmied	Czech
schubert	Czech
schwarz	Czech
schwartz	Czech
sedmik	Czech
sedmikova	Czech
seger	Czech
sekovora	Czech
semick	Czech
serak	Czech
sherak	Czech
shima	Czech
shula	Czech
siegl	Czech
silhan	Czech
simecek	Czech
simodines	Czech
simonek	Czech
sip	Czech
sitta	Czech
skala	Czech
skeril	Czech
skokan	Czech
skomicka	Czech
skwor	Czech
slapnickova	Czech
slejtr	Czech
slepicka	Czech
slepica	Czech
slezak	Czech
slivka	Czech
smith	Czech
snelker	Czech
sokolik	Czech
soucek	Czech
soukup	Czech
spicka	Czech
spoerl	Czech
sponer	Czech
srda	Czech
srpcikova	Czech
stangl	Czech
stanzel	Czech
stary	Czech
staska	Czech
stedronsky	Czech
stegon	Czech
sztegon	Czech
steinborn	Czech
stepan	Czech
stites	Czech
stluka	Czech
stotzky	Czech
strakao	Czech
stramba	Czech
stupka	Czech
subertova	Czech
suchanka	Czech
sula	Czech
svejda	Czech
svejkovsky	Czech
svoboda	Czech
tejc	Czech
tikal	Czech
tykal	Czech
till	Czech
timpe	Czech
timpy	Czech
toman	Czech
tomanek	Czech
tomasek	Czech
tomes	Czech
trampotova	Czech
trampota	Czech
treblik	Czech
trnkova	Czech
uerling	Czech
uhlik	Czech
urbanek	Czech
urbanovska	Czech
urista	Czech
ustohal	Czech
vaca	Czech
vaculova	Czech
vavra	Czech
vejvoda	Czech
veverka	Czech
victor	Czech
vlach	Czech
vlasak	Czech
vlasek	Czech
volcik	Czech
voneve	Czech
votke	Czech
vozab	Czech
vrazel	Czech
vykruta	Czech
wykruta	Czech
waclauska	Czech
weichert	Czech
weineltk	Czech
weisener	Czech
wiesner	Czech
wizner	Czech
weiss	Czech
werlla	Czech
whitmire	Czech
widerlechner	Czech
wilchek	Czech
wondracek	Czech
wood	Czech
zajicek	Czech
zak	Czech
zaruba	Czech
zelinka	Czech
zeman	Czech
zimola	Czech
zipperer	Czech
zitka	Czech
zoucha	Czech
zwolenksy	Czech
aalsburg	Dutch
aalst	Dutch
aarle	Dutch
achteren	Dutch
achthoven	Dutch
adrichem	Dutch
aggelen	Dutch
agteren	Dutch
agthoven	Dutch
akkeren	Dutch
aller	Dutch
alphen	Dutch
alst	Dutch
altena	Dutch
althuis	Dutch
amelsvoort	Dutch
amersvoort	Dutch
amstel	Dutch
andel	Dutch
andringa	Dutch
ankeren	Dutch
antwerp	Dutch
antwerpen	Dutch
apeldoorn	Dutch
arendonk	Dutch
asch	Dutch
assen	Dutch
baarle	Dutch
bokhoven	Dutch
breda	Dutch
bueren	Dutch
buggenum	Dutch
buiren	Dutch
buren	Dutch
can	Dutch
cann	Dutch
canne	Dutch
daal	Dutch
daalen	Dutch
dael	Dutch
daele	Dutch
dale	Dutch
dalen	Dutch
laar	Dutch
vliert	Dutch
akker	Dutch
denend	Dutch
aart	Dutch
beek	Dutch
berg	Dutch
hout	Dutch
see	Dutch
stoep	Dutch
veen	Dutch
ven	Dutch
venn	Dutch
venne	Dutch
vennen	Dutch
zee	Dutch
donk	Dutch
haanraads	Dutch
haanraats	Dutch
haanrade	Dutch
haanrath	Dutch
haenraats	Dutch
haenraets	Dutch
hanraets	Dutch
hassel	Dutch
hautem	Dutch
hautum	Dutch
heel	Dutch
herten	Dutch
hofwegen	Dutch
horn	Dutch
houte	Dutch
houtem	Dutch
houten	Dutch
houttum	Dutch
houtum	Dutch
kan	Dutch
kann	Dutch
kanne	Dutch
kappel	Dutch
karl	Dutch
kikkert	Dutch
klein	Dutch
klerk	Dutch
klerken	Dutch
klerks	Dutch
klerkse	Dutch
klerkx	Dutch
klerx	Dutch
kloet	Dutch
kloeten	Dutch
kloeter	Dutch
koeman	Dutch
koemans	Dutch
kolen	Dutch
kolijn	Dutch
kollen	Dutch
koning	Dutch
kool	Dutch
koole	Dutch
koolen	Dutch
kools	Dutch
kouman	Dutch
koumans	Dutch
krantz	Dutch
kranz	Dutch
krusen	Dutch
kuijpers	Dutch
kuiper	Dutch
kuipers	Dutch
langbroek	Dutch
laren	Dutch
lauwens	Dutch
lauwers	Dutch
leeuwenhoeck	Dutch
leeuwenhoek	Dutch
lucas	Dutch
lucassen	Dutch
lyon	Dutch
maas	Dutch
maes	Dutch
maessen	Dutch
marquering	Dutch
marqueringh	Dutch
marquerink	Dutch
mas	Dutch
meeuwe	Dutch
meeuwes	Dutch
meeuwessen	Dutch
meeuweszen	Dutch
meeuwis	Dutch
meeuwissen	Dutch
meeuwsen	Dutch
meisner	Dutch
merckx	Dutch
mertens	Dutch
michel	Dutch
middelburg	Dutch
middlesworth	Dutch
mohren	Dutch
mooren	Dutch
mulder	Dutch
muyskens	Dutch
nagel	Dutch
nelissen	Dutch
nifterick	Dutch
nifterik	Dutch
niftrik	Dutch
offermans	Dutch
ogterop	Dutch
ogtrop	Dutch
oirschot	Dutch
oirschotten	Dutch
oomen	Dutch
oorschot	Dutch
ophoven	Dutch
otten	Dutch
pander	Dutch
panders	Dutch
paulis	Dutch
paulissen	Dutch
peerenboom	Dutch
peeters	Dutch
peij	Dutch
pender	Dutch
penders	Dutch
pennders	Dutch
penner	Dutch
penners	Dutch
peter	Dutch
peusen	Dutch
pey	Dutch
philips	Dutch
prinsen	Dutch
rademaker	Dutch
rademakers	Dutch
ramaaker	Dutch
ramaker	Dutch
ramakers	Dutch
ramecker	Dutch
rameckers	Dutch
raske	Dutch
reijnder	Dutch
reijnders	Dutch
reinder	Dutch
reinders	Dutch
reynder	Dutch
reynders	Dutch
richard	Dutch
rietveld	Dutch
rijnder	Dutch
rijnders	Dutch
robert	Dutch
roggeveen	Dutch
roijacker	Dutch
roijackers	Dutch
roijakker	Dutch
roijakkers	Dutch
romeijn	Dutch
romeijnders	Dutch
romeijnsen	Dutch
romijn	Dutch
romijnders	Dutch
romijnsen	Dutch
rompa	Dutch
rompaeij	Dutch
rompaey	Dutch
rompaij	Dutch
rompay	Dutch
rompaye	Dutch
rompu	Dutch
rompuy	Dutch
rooiakker	Dutch
rooiakkers	Dutch
rooijakker	Dutch
rooijakkers	Dutch
roosa	Dutch
roosevelt	Dutch
rossem	Dutch
rossum	Dutch
rumpade	Dutch
rutten	Dutch
ryskamp	Dutch
samson	Dutch
sanna	Dutch
schenck	Dutch
schermer	Dutch
schneider	Dutch
schneiders	Dutch
schneijder	Dutch
schneijders	Dutch
schoonenburg	Dutch
schoonraad	Dutch
schoorel	Dutch
schoorl	Dutch
schorel	Dutch
schrijnemakers	Dutch
schuyler	Dutch
schwarzenberg	Dutch
seeger	Dutch
seegers	Dutch
seelen	Dutch
segers	Dutch
segher	Dutch
seghers	Dutch
severijns	Dutch
severins	Dutch
sevriens	Dutch
silje	Dutch
simon	Dutch
simonis	Dutch
slootmaekers	Dutch
smeets	Dutch
smets	Dutch
smit	Dutch
smits	Dutch
snaaijer	Dutch
snaijer	Dutch
sneiders	Dutch
sneijder	Dutch
sneijders	Dutch
sneijer	Dutch
sneijers	Dutch
snell	Dutch
snider	Dutch
sniders	Dutch
snijder	Dutch
snijders	Dutch
snyder	Dutch
snyders	Dutch
specht	Dutch
spijker	Dutch
spiker	Dutch
teravest	Dutch
teunissen	Dutch
theunissen	Dutch
tholberg	Dutch
tillens	Dutch
tunison	Dutch
tunneson	Dutch
vandale	Dutch
vandroogenbroeck	Dutch
vann	Dutch
abel	French
abraham	French
adam	French
albert	French
allard	French
archambault	French
armistead	French
arthur	French
augustin	French
babineaux	French
baudin	French
beauchene	French
beaulieu	French
beaumont	French
belanger	French
bellamy	French
bellerose	French
belrose	French
berger	French
beringer	French
bernard	French
bertrand	French
bisset	French
bissette	French
blaise	French
blanc	French
blanchet	French
blanchett	French
bonfils	French
bonheur	French
bonhomme	French
bonnaire	French
bonnay	French
bonner	French
bonnet	French
borde	French
bordelon	French
bouchard	French
boucher	French
brisbois	French
brodeur	French
bureau	French
caron	French
cavey	French
chaput	French
charbonneau	French
charpentier	French
charron	French
chastain	French
chevalier	French
chevrolet	French
cloutier	French
colbert	French
comtois	French
cornett	French
cote	French
coupe	French
courtemanche	French
cousineau	French
couture	French
daniau	French
daramitz	French
daviau	French
david	French
deforest	French
degarmo	French
delacroix	French
delafontaine	French
deniau	French
deniaud	French
deniel	French
denis	French
desauveterre	French
deschamps	French
descoteaux	French
desjardins	French
desrochers	French
desrosiers	French
dubois	French
duchamps	French
dufort	French
dufour	French
duguay	French
dupond	French
dupont	French
durand	French
durant	French
duval	French
emile	French
eustis	French
fabian	French
fabre	French
fabron	French
faucher	French
faucheux	French
faure	French
favager	French
favre	French
favreau	French
fay	French
felix	French
firmin	French
fontaine	French
forest	French
forestier	French
fortier	French
foss	French
fournier	French
gage	French
gagne	French
gagnier	French
gagnon	French
garcon	French
gardinier	French
germain	French
geroux	French
giles	French
girard	French
giroux	French
glaisyer	French
gosse	French
gosselin	French
granger	French
guerin	French
guillory	French
hardy	French
harman	French
hebert	French
herbert	French
herriot	French
jacques	French
janvier	French
jordan	French
joubert	French
labelle	French
lachance	French
lachapelle	French
lamar	French
lambert	French
lane	French
langlais	French
langlois	French
lapointe	French
larue	French
laurent	French
lavigne	French
lavoie	French
leandres	French
lebeau	French
leblanc	French
leclair	French
leclerc	French
lecuyer	French
lefebvre	French
lefevre	French
lefurgey	French
legrand	French
lemaire	French
lemieux	French
leon	French
leroy	French
lesauvage	French
lestrange	French
leveque	French
levesque	French
linville	French
lyon	French
macon	French
marchand	French
marie	French
marion	French
martel	French
martin	French
masson	French
mathieu	French
mercier	French
merle	French
michaud	French
michel	French
monet	French
monette	French
montagne	French
moreau	French
moulin	French
mullins	French
noel	French
oliver	French
olivier	French
page	French
paget	French
palomer	French
pan	French
pape	French
paquet	French
parent	French
paris	French
parris	French
pascal	French
patenaude	French
paternoster	French
paul	French
pelletier	French
perrault	French
perreault	French
perrot	French
petit	French
pettigrew	French
pierre	French
plamondon	French
plourde	French
poingdestre	French
poirier	French
porcher	French
poulin	French
proulx	French
renaud	French
rey	French
reyer	French
richard	French
richelieu	French
robert	French
roche	French
rome	French
romilly	French
rose	French
rousseau	French
roux	French
roy	French
royer	French
salomon	French
salvage	French
samson	French
samuel	French
sargent	French
sarkozi	French
sarkozy	French
sartre	French
sault	French
sauvage	French
sauvageau	French
sauvageon	French
sauvageot	French
sauveterre	French
savatier	French
segal	French
sergeant	French
severin	French
simon	French
solomon	French
soucy	French
stmartin	French
stpierre	French
tailler	French
tasse	French
thayer	French
thibault	French
thomas	French
tobias	French
tolbert	French
traver	French
travere	French
travers	French
traverse	French
travert	French
tremblay	French
tremble	French
victor	French
victors	French
villeneuve	French
vincent	French
vipond	French
voclain	French
yount	French
abbing	German
abel	German
abeln	German
abt	German
achilles	German
achterberg	German
acker	German
ackermann	German
adam	German
adenauer	German
adler	German
adlersflugel	German
aeschelman	German
albert	German
albrecht	German
aleshire	German
aleshite	German
althaus	German
amsel	German
andres	German
armbruster	German
artz	German
aue	German
auer	German
augustin	German
aust	German
autenburg	German
auttenberg	German
baasch	German
bach	German
bachmeier	German
backer	German
bader	German
bahr	German
bambach	German
bauer	German
bauers	German
baum	German
baumann	German
baumbach	German
baumgartner	German
baumhauer	German
bayer	German
beck	German
becke	German
beckenbauer	German
becker	German
beckert	German
behrend	German
behrends	German
beitel	German
beltz	German
benn	German
berg	German
berger	German
bergfalk	German
beringer	German
bernat	German
best	German
beutel	German
beyer	German
beyersdorf	German
bieber	German
biermann	German
bischoffs	German
blau	German
blecher	German
bleier	German
blumenthal	German
blumstein	German
bocker	German
boehler	German
boer	German
boesch	German
bohler	German
bohm	German
bohme	German
bohmer	German
bohn	German
borchard	German
bosch	German
bottcher	German
brahms	German
brand	German
brandt	German
brant	German
brauer	German
braun	German
braune	German
breiner	German
breisacher	German
breitbarth	German
bretz	German
brinkerhoff	German
brodbeck	German
brose	German
brotz	German
bruhn	German
brun	German
brune	German
buchholz	German
buckholtz	German
buhr	German
bumgarner	German
burgstaller	German
busch	German
carver	German
chevrolet	German
cline	German
dahl	German
denzel	German
derrick	German
diefenbach	German
dieter	German
dietrich	German
dirchs	German
dittmar	German
dohman	German
drechsler	German
dreher	German
dreschner	German
dresdner	German
dressler	German
duerr	German
dunkle	German
dunst	German
durr	German
eberhardt	German
ebner	German
eckstein	German
egger	German
eichel	German
eilerts	German
engel	German
enns	German
esser	German
essert	German
everhart	German
fabel	German
faerber	German
falk	German
falkenrath	German
farber	German
fashingbauer	German
faust	German
feigenbaum	German
feld	German
feldt	German
fenstermacher	German
fertig	German
fiedler	German
fischer	German
flater	German
fleischer	German
foerstner	German
forst	German
forstner	German
foth	German
frank	German
franke	German
frei	German
freud	German
freudenberger	German
freund	German
fried	German
friedrich	German
fromm	German
frost	German
fuchs	German
fuhrmann	German
furst	German
fux	German
gabler	German
gaertner	German
garb	German
garber	German
gartner	German
garver	German
gass	German
gehrig	German
gehring	German
geier	German
geiger	German
geisler	German
geissler	German
geiszler	German
gensch	German
gerber	German
gerhard	German
gerhardt	German
gerig	German
gerst	German
gerstle	German
gerver	German
giehl	German
giese	German
glockner	German
goebel	German
goldschmidt	German
gorman	German
gott	German
gotti	German
gottlieb	German
gottschalk	German
graner	German
greenberg	German
groos	German
gros	German
gross	German
gro	German
groe	German
grosse	German
groel	German
groer	German
grosser	German
grosz	German
grunewald	German
gunther	German
gutermuth	German
gwerder	German
haas	German
haase	German
haber	German
habich	German
habicht	German
hafner	German
hahn	German
hall	German
halle	German
harman	German
hartmann	German
hase	German
hasek	German
hasenkamp	German
hass	German
hauer	German
haupt	German
hausler	German
havener	German
heidrich	German
heinrich	German
heinrichs	German
heintze	German
hellewege	German
heppenheimer	German
herbert	German
hermann	German
herrmann	German
herschel	German
hertz	German
hildebrand	German
hinrichs	German
hintzen	German
hirsch	German
hoch	German
hochberg	German
hoefler	German
hofer	German
hoffman	German
hoffmann	German
hofler	German
hofmann	German
hofmeister	German
holst	German
holtzer	German
holzer	German
holzknecht	German
holzmann	German
hoover	German
horn	German
horowitz	German
houk	German
huber	German
huff	German
huffman	German
huffmann	German
hummel	German
hutmacher	German
ingersleben	German
jaeger	German
jager	German
jans	German
janson	German
janz	German
jollenbeck	German
jordan	German
jund	German
jung	German
junge	German
kahler	German
kaiser	German
kalb	German
kalbfleisch	German
kappel	German
karl	German
kaspar	German
kassmeyer	German
kastner	German
katz	German
kaube	German
kaufer	German
kauffmann	German
kaufman	German
keil	German
keller	German
kempf	German
kerner	German
kerper	German
kerwar	German
kerwer	German
kiefer	German
kirchner	German
kistler	German
kistner	German
kleid	German
klein	German
klossner	German
knef	German
kneib	German
kneller	German
knepp	German
knochenmus	German
knopf	German
knopp	German
koch	German
kock	German
koenig	German
koenigsmann	German
kohl	German
kohler	German
kolbe	German
konig	German
konigsmann	German
kopp	German
kraemer	German
kramer	German
krantz	German
kranz	German
kraus	German
krause	German
krauss	German
krau	German
krebs	German
kroger	German
kron	German
kruckel	German
kruger	German
kruse	German
kuchler	German
kuhn	German
kundert	German
kunkel	German
kunkle	German
kuntz	German
kunze	German
kurzmann	German
laberenz	German
lafrentz	German
lafrenz	German
landau	German
lang	German
lange	German
langenberg	German
langer	German
larenz	German
laurenz	German
lauritz	German
lawerenz	German
lawrenz	German
lehmann	German
lehrer	German
leitner	German
leitz	German
leitzke	German
lenz	German
leverenz	German
lewerentz	German
lewerenz	German
lichtenberg	German
lieberenz	German
linden	German
loewe	German
lohrenz	German
lorentz	German
lorenz	German
lorenzen	German
loris	German
loritz	German
lowe	German
ludwig	German
luther	German
maas	German
maier	German
mandel	German
mann	German
markwardt	German
marquardt	German
marquering	German
marquerink	German
martell	German
martin	German
martz	German
mas	German
maurer	German
maus	German
mayer	German
meier	German
mein	German
meindl	German
meinhardt	German
meisner	German
meissner	German
melsbach	German
mendel	German
mendelsohn	German
mendelssohn	German
messer	German
messerli	German
messmann	German
messner	German
metz	German
metzger	German
meyer	German
michel	German
mohren	German
moller	German
morgenstern	German
moser	German
mueller	German
muhlfeld	German
muller	German
nagel	German
neuman	German
neumann	German
nuremberg	German
nussbaum	German
nussenbaum	German
oberst	German
oelberg	German
ohme	German
oliver	German
oppenheimer	German
ott	German
otto	German
oursler	German
pahlke	German
papke	German
papp	German
paternoster	German
paul	German
paulis	German
pawlitzki	German
penzig	German
peter	German
peters	German
pfaff	German
pfenning	German
plank	German
pletcher	German
porsche	German
portner	German
prinz	German
protz	German
rademacher	German
rademaker	German
rapp	German
raske	German
raskob	German
raskop	German
raskoph	German
regenbogen	German
reier	German
reiher	German
reiter	German
rettig	German
reuter	German
richard	German
richter	German
rier	German
riese	German
ritter	German
rose	German
rosenberg	German
rosenberger	German
rosenfeld	German
rot	German
roth	German
rothbauer	German
rothenberg	German
rothschild	German
sachs	German
saller	German
salomon	German
salzwedel	German
samuel	German
sander	German
sauber	German
schafer	German
scheer	German
scheinberg	German
schenck	German
schermer	German
schindler	German
schirmer	German
schlender	German
schlimme	German
schlusser	German
schmeling	German
schmid	German
schmidt	German
schmitt	German
schmitz	German
schneider	German
schnoor	German
schnur	German
schoettmer	German
schrader	German
schreck	German
schreier	German
schroder	German
schroeder	German
schroeter	German
schroter	German
schubert	German
schuchard	German
schuchardt	German
schuchert	German
schuhart	German
schuhmacher	German
schuler	German
schult	German
schulte	German
schultes	German
schultheis	German
schultheiss	German
schulthei	German
schultz	German
schultze	German
schulz	German
schulze	German
schumacher	German
schuster	German
schuttmann	German
schwangau	German
schwartz	German
schwarz	German
schwarzenegger	German
schwenke	German
schwinghammer	German
seelenfreund	German
seidel	German
senft	German
sheinfeld	German
shriver	German
siegel	German
siekert	German
siemon	German
silverstein	German
simen	German
simmon	German
simon	German
simons	German
siskin	German
siskind	German
sitz	German
slusser	German
solberg	German
sommer	German
sonnen	German
sorg	German
sorge	German
spannagel	German
specht	German
spellmeyer	German
spitznogle	German
sponaugle	German
stark	German
stauss	German
steen	German
steffen	German
stein	German
steinmann	German
stenger	German
sternberg	German
steube	German
steuben	German
stieber	German
stoppelbein	German
strand	German
straub	German
strobel	German
strohkirch	German
stroman	German
stuber	German
stueck	German
stumpf	German
sturm	German
suess	German
sulzbach	German
swango	German
switzer	German
tangeman	German
tanzer	German
teufel	German
tiedeman	German
tifft	German
tillens	German
tobias	German
tolkien	German
tresler	German
tritten	German
trumbauer	German
tschida	German
unkle	German
unruh	German
unterbrink	German
ursler	German
vann	German
vantonder	German
vieth	German
vogel	German
vogt	German
vogts	German
voigt	German
voigts	German
volk	German
voll	German
vonbrandt	German
vonessen	German
vongrimmelshausen	German
voningersleben	German
vonnegut	German
vonwegberg	German
voss	German
vo	German
wagner	German
wahner	German
waldfogel	German
waldvogel	German
walkenhorst	German
walter	German
walther	German
waltz	German
wang	German
warner	German
waxweiler	German
weber	German
wechsler	German
wedekind	German
weeber	German
wegener	German
wegner	German
wehner	German
wehunt	German
weigand	German
weiman	German
weiner	German
weiss	German
wei	German
welter	German
wendel	German
wendell	German
werner	German
wernher	German
west	German
westerberg	German
wetterman	German
wetzel	German
wexler	German
wieck	German
wiegand	German
wildgrube	German
winter	German
winther	German
wirner	German
wirnhier	German
wirt	German
wirth	German
wolf	German
wolff	German
wolter	German
worner	German
wornhor	German
wruck	German
wyman	German
xylander	German
zellweger	German
zilberschlag	German
zimmerman	German
zimmermann	German
adamidis	Greek
adamou	Greek
agelakos	Greek
akrivopoulos	Greek
alexandropoulos	Greek
anetakis	Greek
angelopoulos	Greek
antimisiaris	Greek
antipas	Greek
antonakos	Greek
antoniadis	Greek
antonopoulos	Greek
arvanitoyannis	Greek
avgerinos	Greek
banos	Greek
batsakis	Greek
bekyros	Greek
belesis	Greek
bertsimas	Greek
bilias	Greek
blades	Greek
bouloukos	Greek
brisimitzakis	Greek
bursinos	Greek
calogerakis	Greek
calpis	Greek
chellos	Greek
christakos	Greek
christodoulou	Greek
christou	Greek
chrysanthopoulos	Greek
comino	Greek
close	Greek
dalianis	Greek
danas	Greek
dasios	Greek
demakis	Greek
demarchis	Greek
demas	Greek
demetrious	Greek
dertilis	Greek
diakogeorgiou	Greek
dioletis	Greek
dounias	Greek
dritsas	Greek
drivakis	Greek
eatros	Greek
egonidis	Greek
eliopoulos	Greek
forakis	Greek
fotopoulos	Greek
fourakis	Greek
frangopoulos	Greek
galanopoulos	Greek
garofalis	Greek
gavril	Greek
gavrilopoulos	Greek
georgeakopoulos	Greek
geracimos	Greek
gianakopulos	Greek
giannakopoulos	Greek
giannakos	Greek
glynatsis	Greek
gomatos	Greek
grammatakakis	Greek
gravari	Greek
hadjiyianakies	Greek
hagias	Greek
haritopoulos	Greek
honjas	Greek
horiatis	Greek
houlis	Greek
jamussa	Greek
kaglantge	Greek
kalakos	Greek
kalogeria	Greek
kaloxylos	Greek
kanavos	Greek
kapsimalles	Greek
karahalios	Greek
karameros	Greek
karkampasis	Greek
karnoupakis	Greek
katsourinis	Greek
kefalas	Greek
kokkali	Greek
kokoris	Greek
kolovos	Greek
konstantatos	Greek
kosmas	Greek
kotsilimbas	Greek
kotsiopoulos	Greek
kouches	Greek
koulaxizis	Greek
koumanidis	Greek
kourempes	Greek
kouretas	Greek
kouropoulos	Greek
kouros	Greek
koustoubos	Greek
koutsoubos	Greek
kreskas	Greek
kringos	Greek
kyritsis	Greek
laganas	Greek
leontarakis	Greek
letsos	Greek
liatos	Greek
lillis	Greek
lolos	Greek
louverdis	Greek
makricosta	Greek
malihoudis	Greek
maneates	Greek
manos	Greek
manoukarakis	Greek
matsoukis	Greek
mentis	Greek
mersinias	Greek
metrofanis	Greek
michalaras	Greek
milionis	Greek
missiakos	Greek
moraitopoulos	Greek
nikolaou	Greek
nomikos	Greek
paitakes	Greek
paloumbas	Greek
panayiotopoulos	Greek
panoulias	Greek
pantelakos	Greek
pantelas	Greek
papadelias	Greek
papadopulos	Greek
papageorge	Greek
papoutsis	Greek
pappayiorgas	Greek
paraskevopoulos	Greek
paraskos	Greek
paschalis	Greek
patrianakos	Greek
patselas	Greek
pefanis	Greek
petimezas	Greek
petrakis	Greek
pezos	Greek
phocas	Greek
pispinis	Greek
polites	Greek
polymenakou	Greek
poniros	Greek
protopsaltis	Greek
rallis	Greek
rigatos	Greek
rorris	Greek
rousses	Greek
ruvelas	Greek
sakelaris	Greek
sakellariou	Greek
samios	Greek
sardelis	Greek
sfakianos	Greek
sklavenitis	Greek
sortras	Greek
sotiris	Greek
spyridis	Greek
stamatas	Greek
stamatelos	Greek
stavropoulos	Greek
strilakos	Greek
stroggylis	Greek
tableriou	Greek
taflambas	Greek
tassioglou	Greek
telis	Greek
tsoumada	Greek
theofilopoulos	Greek
theohari	Greek
totolos	Greek
tourna	Greek
tsahalis	Greek
tsangaris	Greek
tselios	Greek
tsogas	Greek
vamvakidis	Greek
varvitsiotes	Greek
vassilikos	Greek
vassilopulos	Greek
vlahos	Greek
vourlis	Greek
xydis	Greek
zaloumi	Greek
zouvelekis	Greek
adam	Irish
ahearn	Irish
aodh	Irish
aodha	Irish
aonghuis	Irish
aonghus	Irish
bhrighde	Irish
bradach	Irish
bradan	Irish
braden	Irish
brady	Irish
bran	Irish
brannon	Irish
brian	Irish
callaghan	Irish
caomh	Irish
carey	Irish
casey	Irish
cassidy	Irish
cathain	Irish
cathan	Irish
cathasach	Irish
ceallach	Irish
ceallachan	Irish
cearbhall	Irish
cennetig	Irish
ciardha	Irish
clark	Irish
cleirich	Irish
cleirigh	Irish
cnaimhin	Irish
coghlan	Irish
coilean	Irish
collins	Irish
colman	Irish
conall	Irish
conchobhar	Irish
conn	Irish
connell	Irish
connolly	Irish
cormac	Irish
corraidhin	Irish
cuidightheach	Irish
curran	Irish
dubhshlaine	Irish
dalach	Irish
daly	Irish
damhain	Irish
damhan	Irish
delaney	Irish
desmond	Irish
devin	Irish
diarmaid	Irish
doherty	Irish
domhnall	Irish
donnchadh	Irish
donndubhan	Irish
donnell	Irish
donoghue	Irish
donovan	Irish
doyle	Irish
dubhain	Irish
dubhan	Irish
duncan	Irish
eoghan	Irish
eoin	Irish
faolan	Irish
farrell	Irish
fearghal	Irish
fergus	Irish
finn	Irish
finnegan	Irish
fionn	Irish
flanagan	Irish
flann	Irish
flynn	Irish
gallchobhar	Irish
gerald	Irish
giolla	Irish
gorman	Irish
hayden	Irish
ivor	Irish
john	Irish
kavanagh	Irish
keefe	Irish
kelly	Irish
kennedy	Irish
lennon	Irish
login	Irish
macclelland	Irish
macdermott	Irish
maceachthighearna	Irish
macfarland	Irish
macghabhann	Irish
maciomhair	Irish
macshuibhne	Irish
madaidhin	Irish
madden	Irish
maguire	Irish
mahoney	Irish
maille	Irish
malone	Irish
manus	Irish
maolmhuaidh	Irish
mathghamhain	Irish
maurice	Irish
mcguire	Irish
mckay	Irish
mclain	Irish
mcmahon	Irish
mcnab	Irish
mcneil	Irish
meadhra	Irish
michael	Irish
milligan	Irish
mochan	Irish
mohan	Irish
molloy	Irish
monahan	Irish
mooney	Irish
muirchertach	Irish
mullen	Irish
mulryan	Irish
murchadh	Irish
murphy	Irish
names	Irish
naoimhin	Irish
naomhan	Irish
neil	Irish
neville	Irish
nevin	Irish
niadh	Irish
niall	Irish
nolan	Irish
nuallan	Irish
oboyle	Irish
obrien	Irish
obyrne	Irish
odonnell	Irish
ohannagain	Irish
ohannigain	Irish
okeefe	Irish
omooney	Irish
oneal	Irish
obree	Irish
obrian	Irish
ocallaghann	Irish
oconnell	Irish
oconnor	Irish
odell	Irish
odoherty	Irish
odonoghue	Irish
odowd	Irish
odriscoll	Irish
ogorman	Irish
ogrady	Irish
ohagan	Irish
ohalloran	Irish
ohanlon	Irish
ohara	Irish
ohare	Irish
okane	Irish
okeeffe	Irish
okelly	Irish
oleary	Irish
oloughlin	Irish
omahoney	Irish
omahony	Irish
omalley	Irish
omeara	Irish
oneill	Irish
oreilly	Irish
orourke	Irish
oryan	Irish
oshea	Irish
osullivan	Irish
otoole	Irish
patrick	Irish
peatain	Irish
pharlain	Irish
power	Irish
quigley	Irish
quinn	Irish
quirke	Irish
raghailligh	Irish
reagan	Irish
register	Irish
reilly	Irish
reynold	Irish
rhys	Irish
riagain	Irish
riagan	Irish
riain	Irish
rian	Irish
rinn	Irish
roach	Irish
rodagh	Irish
rory	Irish
ruadh	Irish
ruadhain	Irish
ruadhan	Irish
ruaidh	Irish
samuel	Irish
scolaidhe	Irish
seaghdha	Irish
sechnall	Irish
seighin	Irish
shannon	Irish
sheehy	Irish
simon	Irish
sioda	Irish
sloan	Irish
sluaghadhan	Irish
suaird	Irish
sullivan	Irish
tadhg	Irish
tadhgan	Irish
taidhg	Irish
teagan	Irish
teague	Irish
tighearnach	Irish
tracey	Irish
treasach	Irish
whalen	Irish
whelan	Irish
william	Irish
abandonato	Italian
abatangelo	Italian
abatantuono	Italian
abate	Italian
abategiovanni	Italian
abatescianni	Italian
abba	Italian
abbadelli	Italian
abbascia	Italian
abbatangelo	Italian
abbatantuono	Italian
abbate	Italian
abbatelli	Italian
abbaticchio	Italian
abbiati	Italian
abbracciabene	Italian
abbracciabeni	Italian
abelli	Italian
abello	Italian
abrami	Italian
abramo	Italian
acardi	Italian
accardi	Italian
accardo	Italian
acciai	Italian
acciaio	Italian
acciaioli	Italian
acconci	Italian
acconcio	Italian
accorsi	Italian
accorso	Italian
accosi	Italian
accursio	Italian
acerbi	Italian
acone	Italian
aconi	Italian
acqua	Italian
acquafredda	Italian
acquarone	Italian
acquati	Italian
adalardi	Italian
adami	Italian
adamo	Italian
adamoli	Italian
addario	Italian
adelardi	Italian
adessi	Italian
adimari	Italian
adriatico	Italian
affini	Italian
africani	Italian
africano	Italian
agani	Italian
aggi	Italian
aggio	Italian
agli	Italian
agnelli	Italian
agnellutti	Italian
agnusdei	Italian
agosti	Italian
agostini	Italian
agresta	Italian
agrioli	Italian
aiello	Italian
aiolfi	Italian
airaldi	Italian
airo	Italian
aita	Italian
ajello	Italian
alagona	Italian
alamanni	Italian
albanesi	Italian
albani	Italian
albano	Italian
alberghi	Italian
alberghini	Italian
alberici	Italian
alberighi	Italian
albero	Italian
albini	Italian
albricci	Italian
albrici	Italian
alcheri	Italian
aldebrandi	Italian
alderisi	Italian
alduino	Italian
alemagna	Italian
aleppo	Italian
alesci	Italian
alescio	Italian
alesi	Italian
alesini	Italian
alesio	Italian
alessandri	Italian
alessi	Italian
alfero	Italian
aliberti	Italian
alinari	Italian
aliprandi	Italian
allegri	Italian
allegro	Italian
alo	Italian
aloia	Italian
aloisi	Italian
altamura	Italian
altimari	Italian
altoviti	Italian
alunni	Italian
amadei	Italian
amadori	Italian
amalberti	Italian
amantea	Italian
amato	Italian
amatore	Italian
ambrogi	Italian
ambrosi	Italian
amello	Italian
amerighi	Italian
amoretto	Italian
angioli	Italian
ansaldi	Italian
anselmetti	Italian
anselmi	Italian
antonelli	Italian
antonini	Italian
antonino	Italian
aquila	Italian
aquino	Italian
arbore	Italian
ardiccioni	Italian
ardizzone	Italian
ardovini	Italian
arena	Italian
aringheri	Italian
arlotti	Italian
armani	Italian
armati	Italian
armonni	Italian
arnolfi	Italian
arnoni	Italian
arrighetti	Italian
arrighi	Italian
arrigucci	Italian
aucciello	Italian
azzara	Italian
baggi	Italian
baggio	Italian
baglio	Italian
bagni	Italian
bagnoli	Italian
balboni	Italian
baldi	Italian
baldini	Italian
baldinotti	Italian
baldovini	Italian
bandini	Italian
bandoni	Italian
barbieri	Italian
barone	Italian
barsetti	Italian
bartalotti	Italian
bartolomei	Italian
bartolomeo	Italian
barzetti	Italian
basile	Italian
bassanelli	Italian
bassani	Italian
bassi	Italian
basso	Italian
basurto	Italian
battaglia	Italian
bazzoli	Italian
bellandi	Italian
bellandini	Italian
bellincioni	Italian
bellini	Italian
bello	Italian
bellomi	Italian
belloni	Italian
belluomi	Italian
belmonte	Italian
bencivenni	Italian
benedetti	Italian
benenati	Italian
benetton	Italian
benini	Italian
benivieni	Italian
benvenuti	Italian
berardi	Italian
bergamaschi	Italian
berti	Italian
bertolini	Italian
biancardi	Italian
bianchi	Italian
bicchieri	Italian
biondi	Italian
biondo	Italian
boerio	Italian
bologna	Italian
bondesan	Italian
bonomo	Italian
borghi	Italian
borgnino	Italian
borgogni	Italian
bosco	Italian
bove	Italian
bover	Italian
boveri	Italian
brambani	Italian
brambilla	Italian
breda	Italian
brioschi	Italian
brivio	Italian
brunetti	Italian
bruno	Italian
buffone	Italian
bulgarelli	Italian
bulgari	Italian
buonarroti	Italian
busto	Italian
caiazzo	Italian
caito	Italian
caivano	Italian
calabrese	Italian
calligaris	Italian
campana	Italian
campo	Italian
cantu	Italian
capello	Italian
capitani	Italian
carbone	Italian
carboni	Italian
carideo	Italian
carlevaro	Italian
caro	Italian
carracci	Italian
carrara	Italian
caruso	Italian
cassano	Italian
castro	Italian
catalano	Italian
cattaneo	Italian
cavalcante	Italian
cavallo	Italian
cingolani	Italian
cino	Italian
cipriani	Italian
cisternino	Italian
coiro	Italian
cola	Italian
colombera	Italian
colombo	Italian
columbo	Italian
como	Italian
confortola	Italian
conti	Italian
corna	Italian
corti	Italian
corvi	Italian
costa	Italian
costantini	Italian
costanzo	Italian
cracchiolo	Italian
cremaschi	Italian
cremona	Italian
cremonesi	Italian
crespo	Italian
croce	Italian
crocetti	Italian
cucinotta	Italian
cuocco	Italian
cuoco	Italian
dambrosio	Italian
damiani	Italian
damore	Italian
dangelo	Italian
dantonio	Italian
deangelis	Italian
decampo	Italian
defelice	Italian
defilippis	Italian
defiore	Italian
delaurentis	Italian
deluca	Italian
depalma	Italian
derege	Italian
desantis	Italian
devitis	Italian
diantonio	Italian
dicaprio	Italian
dimercurio	Italian
dinapoli	Italian
dioli	Italian
dipasqua	Italian
dipietro	Italian
distefano	Italian
donati	Italian
donofrio	Italian
drago	Italian
durante	Italian
elena	Italian
episcopo	Italian
ermacora	Italian
esposito	Italian
evangelista	Italian
fabbri	Italian
fabbro	Italian
falco	Italian
faraldo	Italian
farina	Italian
farro	Italian
fattore	Italian
fausti	Italian
fava	Italian
favero	Italian
fermi	Italian
ferrara	Italian
ferrari	Italian
ferraro	Italian
ferrero	Italian
ferro	Italian
fierro	Italian
filippi	Italian
fini	Italian
fiore	Italian
fiscella	Italian
fonda	Italian
fontana	Italian
fortunato	Italian
franco	Italian
franzese	Italian
furlan	Italian
gabrielli	Italian
gagliardi	Italian
gallo	Italian
ganza	Italian
garfagnini	Italian
garofalo	Italian
gaspari	Italian
gatti	Italian
genovese	Italian
gentile	Italian
germano	Italian
giannino	Italian
gimondi	Italian
giordano	Italian
gismondi	Italian
giugovaz	Italian
giunta	Italian
goretti	Italian
gori	Italian
greco	Italian
grillo	Italian
grimaldi	Italian
gronchi	Italian
guarneri	Italian
guerra	Italian
guerriero	Italian
guidi	Italian
guttuso	Italian
idoni	Italian
innocenti	Italian
labriola	Italian
laconi	Italian
lagana	Italian
lagomarsino	Italian
lagorio	Italian
laguardia	Italian
lama	Italian
lamberti	Italian
lamon	Italian
landi	Italian
lando	Italian
landolfi	Italian
laterza	Italian
laurito	Italian
lazzari	Italian
lecce	Italian
leccese	Italian
leggieri	Italian
lemmi	Italian
leone	Italian
leoni	Italian
lippi	Italian
locatelli	Italian
lombardi	Italian
longo	Italian
lupo	Italian
luzzatto	Italian
maestri	Italian
magro	Italian
mancini	Italian
manco	Italian
mancuso	Italian
manfredi	Italian
manfredonia	Italian
mantovani	Italian
marchegiano	Italian
marchesi	Italian
marchetti	Italian
marchioni	Italian
marconi	Italian
mari	Italian
maria	Italian
mariani	Italian
marino	Italian
marmo	Italian
martelli	Italian
martinelli	Italian
masi	Italian
masin	Italian
mazza	Italian
merlo	Italian
messana	Italian
micheli	Italian
milani	Italian
milano	Italian
modugno	Italian
mondadori	Italian
mondo	Italian
montagna	Italian
montana	Italian
montanari	Italian
monte	Italian
monti	Italian
morandi	Italian
morello	Italian
moretti	Italian
morra	Italian
moschella	Italian
mosconi	Italian
motta	Italian
muggia	Italian
muraro	Italian
murgia	Italian
murtas	Italian
nacar	Italian
naggi	Italian
naggia	Italian
naldi	Italian
nana	Italian
nani	Italian
nanni	Italian
nannini	Italian
napoleoni	Italian
napoletani	Italian
napoliello	Italian
nardi	Italian
nardo	Italian
nardovino	Italian
nasato	Italian
nascimbene	Italian
nascimbeni	Italian
natale	Italian
nave	Italian
nazario	Italian
necchi	Italian
negri	Italian
negrini	Italian
nelli	Italian
nenci	Italian
nepi	Italian
neri	Italian
neroni	Italian
nervetti	Italian
nervi	Italian
nespola	Italian
nicastro	Italian
nicchi	Italian
nicodemo	Italian
nicolai	Italian
nicolosi	Italian
nicosia	Italian
nicotera	Italian
nieddu	Italian
nieri	Italian
nigro	Italian
nisi	Italian
nizzola	Italian
noschese	Italian
notaro	Italian
notoriano	Italian
oberti	Italian
oberto	Italian
ongaro	Italian
orlando	Italian
orsini	Italian
pace	Italian
padovan	Italian
padovano	Italian
pagani	Italian
pagano	Italian
palladino	Italian
palmisano	Italian
palumbo	Italian
panzavecchia	Italian
parisi	Italian
parma	Italian
parodi	Italian
parri	Italian
parrino	Italian
passerini	Italian
pastore	Italian
paternoster	Italian
pavesi	Italian
pavone	Italian
pavoni	Italian
pecora	Italian
pedrotti	Italian
pellegrino	Italian
perugia	Italian
pesaresi	Italian
pesaro	Italian
pesce	Italian
petri	Italian
pherigo	Italian
piazza	Italian
piccirillo	Italian
piccoli	Italian
pierno	Italian
pietri	Italian
pini	Italian
piovene	Italian
piraino	Italian
pisani	Italian
pittaluga	Italian
poggi	Italian
poggio	Italian
poletti	Italian
pontecorvo	Italian
portelli	Italian
porto	Italian
portoghese	Italian
potenza	Italian
pozzi	Italian
profeta	Italian
prosdocimi	Italian
provenza	Italian
provenzano	Italian
pugliese	Italian
quaranta	Italian
quattrocchi	Italian
ragno	Italian
raimondi	Italian
rais	Italian
rana	Italian
raneri	Italian
rao	Italian
rapallino	Italian
ratti	Italian
ravenna	Italian
re	Italian
ricchetti	Italian
ricci	Italian
riggi	Italian
righi	Italian
rinaldi	Italian
riva	Italian
rizzo	Italian
robustelli	Italian
rocca	Italian
rocchi	Italian
rocco	Italian
roma	Italian
romagna	Italian
romagnoli	Italian
romano	Italian
romero	Italian
roncalli	Italian
ronchi	Italian
rosa	Italian
rossi	Italian
rossini	Italian
rotolo	Italian
rovigatti	Italian
ruggeri	Italian
russo	Italian
rustici	Italian
ruzzier	Italian
sabbadin	Italian
sacco	Italian
sala	Italian
salomon	Italian
salucci	Italian
salvaggi	Italian
salvai	Italian
salvail	Italian
salvatici	Italian
salvay	Italian
sanna	Italian
sansone	Italian
santini	Italian
santoro	Italian
sapienti	Italian
sarno	Italian
sarti	Italian
sartini	Italian
sarto	Italian
savona	Italian
scarpa	Italian
scarsi	Italian
scavo	Italian
sciacca	Italian
sciacchitano	Italian
sciarra	Italian
scordato	Italian
scotti	Italian
scutese	Italian
sebastiani	Italian
sebastino	Italian
segreti	Italian
selmone	Italian
selvaggio	Italian
serafin	Italian
serafini	Italian
serpico	Italian
sessa	Italian
sgro	Italian
siena	Italian
silvestri	Italian
sinagra	Italian
soldati	Italian
somma	Italian
sordi	Italian
soriano	Italian
sorrentino	Italian
spada	Italian
spano	Italian
sparacello	Italian
speziale	Italian
spini	Italian
stabile	Italian
stablum	Italian
stilo	Italian
sultana	Italian
tafani	Italian
tamaro	Italian
tamboia	Italian
tanzi	Italian
tarantino	Italian
taverna	Italian
tedesco	Italian
terranova	Italian
terzi	Italian
tessaro	Italian
testa	Italian
tiraboschi	Italian
tivoli	Italian
todaro	Italian
toloni	Italian
tornincasa	Italian
toselli	Italian
tosetti	Italian
tosi	Italian
tosto	Italian
trapani	Italian
traversa	Italian
traversi	Italian
traversini	Italian
traverso	Italian
trucco	Italian
trudu	Italian
tumicelli	Italian
turati	Italian
turchi	Italian
uberti	Italian
uccello	Italian
uggeri	Italian
ughi	Italian
ungaretti	Italian
ungaro	Italian
vacca	Italian
vaccaro	Italian
valenti	Italian
valentini	Italian
valerio	Italian
varano	Italian
ventimiglia	Italian
ventura	Italian
verona	Italian
veronesi	Italian
vescovi	Italian
vespa	Italian
vestri	Italian
vicario	Italian
vico	Italian
vigo	Italian
villa	Italian
vinci	Italian
viola	Italian
vitali	Italian
viteri	Italian
voltolini	Italian
zambrano	Italian
zanetti	Italian
zangari	Italian
zappa	Italian
zeni	Italian
zini	Italian
zino	Italian
zunino	Italian
abe	Japanese
abukara	Japanese
adachi	Japanese
aida	Japanese
aihara	Japanese
aizawa	Japanese
ajibana	Japanese
akaike	Japanese
akamatsu	Japanese
akatsuka	Japanese
akechi	Japanese
akera	Japanese
akimoto	Japanese
akita	Japanese
akiyama	Japanese
akutagawa	Japanese
amagawa	Japanese
amaya	Japanese
amori	Japanese
anami	Japanese
ando	Japanese
anzai	Japanese
aoki	Japanese
arai	Japanese
arakawa	Japanese
araki	Japanese
arakida	Japanese
arato	Japanese
arihyoshi	Japanese
arishima	Japanese
arita	Japanese
ariwa	Japanese
ariwara	Japanese
asahara	Japanese
asahi	Japanese
asai	Japanese
asano	Japanese
asanuma	Japanese
asari	Japanese
ashia	Japanese
ashida	Japanese
ashikaga	Japanese
asuhara	Japanese
atshushi	Japanese
ayabito	Japanese
ayugai	Japanese
baba	Japanese
baisotei	Japanese
bando	Japanese
bunya	Japanese
chiba	Japanese
chikamatsu	Japanese
chikanatsu	Japanese
chino	Japanese
chishu	Japanese
choshi	Japanese
daishi	Japanese
dan	Japanese
date	Japanese
dazai	Japanese
deguchi	Japanese
deushi	Japanese
doi	Japanese
ebina	Japanese
ebisawa	Japanese
eda	Japanese
egami	Japanese
eguchi	Japanese
ekiguchi	Japanese
endo	Japanese
endoso	Japanese
enoki	Japanese
enomoto	Japanese
erizawa	Japanese
eto	Japanese
etsuko	Japanese
ezakiya	Japanese
fuchida	Japanese
fugunaga	Japanese
fujikage	Japanese
fujimaki	Japanese
fujimoto	Japanese
fujioka	Japanese
fujishima	Japanese
fujita	Japanese
fujiwara	Japanese
fukao	Japanese
fukayama	Japanese
fukuda	Japanese
fukumitsu	Japanese
fukunaka	Japanese
fukuoka	Japanese
fukusaku	Japanese
fukushima	Japanese
fukuyama	Japanese
fukuzawa	Japanese
fumihiko	Japanese
funabashi	Japanese
funaki	Japanese
funakoshi	Japanese
furusawa	Japanese
fuschida	Japanese
fuse	Japanese
futabatei	Japanese
fuwa	Japanese
gakusha	Japanese
genda	Japanese
genji	Japanese
gensai	Japanese
godo	Japanese
goto	Japanese
gushiken	Japanese
hachirobei	Japanese
haga	Japanese
hagino	Japanese
hagiwara	Japanese
hama	Japanese
hamacho	Japanese
hamada	Japanese
hamaguchi	Japanese
hamamoto	Japanese
hanabusa	Japanese
hanari	Japanese
handa	Japanese
hara	Japanese
harada	Japanese
haruguchi	Japanese
hasegawa	Japanese
hasekura	Japanese
hashimoto	Japanese
hasimoto	Japanese
hatakeda	Japanese
hatakeyama	Japanese
hatayama	Japanese
hatoyama	Japanese
hattori	Japanese
hayakawa	Japanese
hayami	Japanese
hayashi	Japanese
hayashida	Japanese
hayata	Japanese
hayuata	Japanese
hida	Japanese
hideaki	Japanese
hideki	Japanese
hideyoshi	Japanese
higashikuni	Japanese
higashiyama	Japanese
higo	Japanese
higoshi	Japanese
higuchi	Japanese
hike	Japanese
hino	Japanese
hira	Japanese
hiraga	Japanese
hiraki	Japanese
hirano	Japanese
hiranuma	Japanese
hiraoka	Japanese
hirase	Japanese
hirasi	Japanese
hirata	Japanese
hiratasuka	Japanese
hirayama	Japanese
hiro	Japanese
hirose	Japanese
hirota	Japanese
hiroyuki	Japanese
hisamatsu	Japanese
hishida	Japanese
hishikawa	Japanese
hitomi	Japanese
hiyama	Japanese
hohki	Japanese
hojo	Japanese
hokusai	Japanese
honami	Japanese
honda	Japanese
hori	Japanese
horigome	Japanese
horigoshi	Japanese
horiuchi	Japanese
horri	Japanese
hoshino	Japanese
hosokawa	Japanese
hosokaya	Japanese
hotate	Japanese
hotta	Japanese
hyata	Japanese
hyobanshi	Japanese
ibi	Japanese
ibu	Japanese
ibuka	Japanese
ichigawa	Japanese
ichihara	Japanese
ichikawa	Japanese
ichimonji	Japanese
ichiro	Japanese
ichisada	Japanese
ichiyusai	Japanese
idane	Japanese
iemochi	Japanese
ienari	Japanese
iesada	Japanese
ieyasu	Japanese
ieyoshi	Japanese
igarashi	Japanese
ihara	Japanese
ii	Japanese
iida	Japanese
iijima	Japanese
iitaka	Japanese
ijichi	Japanese
ijiri	Japanese
ikeda	Japanese
ikina	Japanese
ikoma	Japanese
imada	Japanese
imagawa	Japanese
imai	Japanese
imaizumi	Japanese
imamura	Japanese
imoo	Japanese
ina	Japanese
inaba	Japanese
inao	Japanese
inihara	Japanese
ino	Japanese
inoguchi	Japanese
inokuma	Japanese
inoue	Japanese
inouye	Japanese
inukai	Japanese
ippitsusai	Japanese
irie	Japanese
iriye	Japanese
isayama	Japanese
ise	Japanese
iseki	Japanese
iseya	Japanese
ishibashi	Japanese
ishida	Japanese
ishiguro	Japanese
ishihara	Japanese
ishikawa	Japanese
ishimaru	Japanese
ishimura	Japanese
ishinomori	Japanese
ishiyama	Japanese
isobe	Japanese
isoda	Japanese
isozaki	Japanese
itagaki	Japanese
itami	Japanese
ito	Japanese
itoh	Japanese
iwahara	Japanese
iwahashi	Japanese
iwakura	Japanese
iwasa	Japanese
iwasaki	Japanese
izumi	Japanese
jimbo	Japanese
jippensha	Japanese
jo	Japanese
joshuya	Japanese
joshuyo	Japanese
jukodo	Japanese
jumonji	Japanese
kada	Japanese
kagabu	Japanese
kagawa	Japanese
kahae	Japanese
kahaya	Japanese
kaibara	Japanese
kaima	Japanese
kajahara	Japanese
kajitani	Japanese
kajiwara	Japanese
kajiyama	Japanese
kakinomoto	Japanese
kakutama	Japanese
kamachi	Japanese
kamata	Japanese
kaminaga	Japanese
kamio	Japanese
kamioka	Japanese
kamisaka	Japanese
kamo	Japanese
kamon	Japanese
kan	Japanese
kanada	Japanese
kanagaki	Japanese
kanegawa	Japanese
kaneko	Japanese
kanesaka	Japanese
kano	Japanese
karamorita	Japanese
karube	Japanese
karubo	Japanese
kasahara	Japanese
kasai	Japanese
kasamatsu	Japanese
kasaya	Japanese
kase	Japanese
kashiwagi	Japanese
kasuse	Japanese
kataoka	Japanese
katayama	Japanese
katayanagi	Japanese
kate	Japanese
kato	Japanese
katoaka	Japanese
katsu	Japanese
katsukawa	Japanese
katsumata	Japanese
katsura	Japanese
katsushika	Japanese
kawabata	Japanese
kawachi	Japanese
kawagichi	Japanese
kawagishi	Japanese
kawaguchi	Japanese
kawai	Japanese
kawaii	Japanese
kawakami	Japanese
kawamata	Japanese
kawamura	Japanese
kawasaki	Japanese
kawasawa	Japanese
kawashima	Japanese
kawasie	Japanese
kawatake	Japanese
kawate	Japanese
kawayama	Japanese
kawazu	Japanese
kaza	Japanese
kazuyoshi	Japanese
kenkyusha	Japanese
kenmotsu	Japanese
kentaro	Japanese
ki	Japanese
kido	Japanese
kihara	Japanese
kijimuta	Japanese
kijmuta	Japanese
kikkawa	Japanese
kikuchi	Japanese
kikugawa	Japanese
kikui	Japanese
kikutake	Japanese
kimio	Japanese
kimiyama	Japanese
kimura	Japanese
kinashita	Japanese
kinoshita	Japanese
kinugasa	Japanese
kira	Japanese
kishi	Japanese
kiski	Japanese
kita	Japanese
kitabatake	Japanese
kitagawa	Japanese
kitamura	Japanese
kitano	Japanese
kitao	Japanese
kitoaji	Japanese
ko	Japanese
kobayashi	Japanese
kobi	Japanese
kodama	Japanese
koga	Japanese
kogara	Japanese
kogo	Japanese
koguchi	Japanese
koiso	Japanese
koizumi	Japanese
kojima	Japanese
kokan	Japanese
komagata	Japanese
komatsu	Japanese
komatsuzaki	Japanese
komine	Japanese
komiya	Japanese
komon	Japanese
komura	Japanese
kon	Japanese
konae	Japanese
konda	Japanese
kondo	Japanese
konishi	Japanese
kono	Japanese
konoe	Japanese
koruba	Japanese
koshin	Japanese
kotara	Japanese
kotoku	Japanese
koyama	Japanese
koyanagi	Japanese
kozu	Japanese
kubo	Japanese
kubota	Japanese
kudara	Japanese
kudo	Japanese
kuga	Japanese
kumagae	Japanese
kumasaka	Japanese
kunda	Japanese
kunikida	Japanese
kunisada	Japanese
kuno	Japanese
kunomasu	Japanese
kuramochi	Japanese
kuramoto	Japanese
kurata	Japanese
kurkawa	Japanese
kurmochi	Japanese
kuroda	Japanese
kurofuji	Japanese
kurogane	Japanese
kurohiko	Japanese
kuroki	Japanese
kurosawa	Japanese
kurusu	Japanese
kusatsu	Japanese
kusonoki	Japanese
kusuhara	Japanese
kusunoki	Japanese
kuwabara	Japanese
kwakami	Japanese
kyubei	Japanese
maeda	Japanese
maehata	Japanese
maeno	Japanese
maita	Japanese
makiguchi	Japanese
makino	Japanese
makioka	Japanese
makuda	Japanese
marubeni	Japanese
marugo	Japanese
marusa	Japanese
maruya	Japanese
maruyama	Japanese
masanobu	Japanese
masaoka	Japanese
mashita	Japanese
masoni	Japanese
masudu	Japanese
masuko	Japanese
masuno	Japanese
masuzoe	Japanese
matano	Japanese
matokai	Japanese
matoke	Japanese
matsuda	Japanese
matsukata	Japanese
matsuki	Japanese
matsumara	Japanese
matsumoto	Japanese
matsumura	Japanese
matsuo	Japanese
matsuoka	Japanese
matsura	Japanese
matsushina	Japanese
matsushita	Japanese
matsuya	Japanese
matsuzawa	Japanese
mayuzumi	Japanese
mazaki	Japanese
mazawa	Japanese
mazuka	Japanese
mifune	Japanese
mihashi	Japanese
miki	Japanese
mimasuya	Japanese
minabuchi	Japanese
minami	Japanese
minamoto	Japanese
minatoya	Japanese
minobe	Japanese
mishima	Japanese
mitsubishi	Japanese
mitsuharu	Japanese
mitsui	Japanese
mitsukuri	Japanese
mitsuwa	Japanese
mitsuya	Japanese
mitzusaka	Japanese
miura	Japanese
miwa	Japanese
miyagi	Japanese
miyahara	Japanese
miyajima	Japanese
miyake	Japanese
miyamae	Japanese
miyamoto	Japanese
miyazaki	Japanese
miyazawa	Japanese
miyoshi	Japanese
mizoguchi	Japanese
mizumaki	Japanese
mizuno	Japanese
mizutani	Japanese
modegi	Japanese
momotami	Japanese
momotani	Japanese
monomonoi	Japanese
mori	Japanese
moriguchi	Japanese
morimoto	Japanese
morinaga	Japanese
morioka	Japanese
morishita	Japanese
morisue	Japanese
morita	Japanese
morri	Japanese
moto	Japanese
motoori	Japanese
motoyoshi	Japanese
munakata	Japanese
munkata	Japanese
muraguchi	Japanese
murakami	Japanese
muraoka	Japanese
murasaki	Japanese
murase	Japanese
murata	Japanese
murkami	Japanese
muro	Japanese
muruyama	Japanese
mushanaokoji	Japanese
mushashibo	Japanese
muso	Japanese
mutsu	Japanese
nagahama	Japanese
nagai	Japanese
nagano	Japanese
nagasawa	Japanese
nagase	Japanese
nagata	Japanese
nagatsuka	Japanese
nagumo	Japanese
naito	Japanese
nakada	Japanese
nakadai	Japanese
nakadan	Japanese
nakae	Japanese
nakagawa	Japanese
nakahara	Japanese
nakajima	Japanese
nakamoto	Japanese
nakamura	Japanese
nakane	Japanese
nakanishi	Japanese
nakano	Japanese
nakanoi	Japanese
nakao	Japanese
nakasato	Japanese
nakasawa	Japanese
nakasone	Japanese
nakata	Japanese
nakatoni	Japanese
nakayama	Japanese
nakazawa	Japanese
namiki	Japanese
nanami	Japanese
narahashi	Japanese
narato	Japanese
narita	Japanese
nataga	Japanese
natsume	Japanese
nawabe	Japanese
nemoto	Japanese
niijima	Japanese
nijo	Japanese
ninomiya	Japanese
nishi	Japanese
nishihara	Japanese
nishikawa	Japanese
nishimoto	Japanese
nishimura	Japanese
nishimuraya	Japanese
nishio	Japanese
nishiwaki	Japanese
nitta	Japanese
nobunaga	Japanese
noda	Japanese
nogi	Japanese
noguchi	Japanese
nogushi	Japanese
nomura	Japanese
nonomura	Japanese
noro	Japanese
nosaka	Japanese
nose	Japanese
nozaki	Japanese
nozara	Japanese
numajiri	Japanese
numata	Japanese
obata	Japanese
obinata	Japanese
obuchi	Japanese
ochiai	Japanese
ochida	Japanese
odaka	Japanese
ogata	Japanese
ogiwara	Japanese
ogura	Japanese
ogyu	Japanese
ohba	Japanese
ohira	Japanese
ohishi	Japanese
ohka	Japanese
ohmae	Japanese
ohmiya	Japanese
oichi	Japanese
oinuma	Japanese
oishi	Japanese
okabe	Japanese
okada	Japanese
okakura	Japanese
okamoto	Japanese
okamura	Japanese
okanao	Japanese
okanaya	Japanese
okano	Japanese
okasawa	Japanese
okawa	Japanese
okazaki	Japanese
okazawaya	Japanese
okimasa	Japanese
okimoto	Japanese
okita	Japanese
okubo	Japanese
okuda	Japanese
okui	Japanese
okuma	Japanese
okumura	Japanese
okura	Japanese
omori	Japanese
omura	Japanese
onishi	Japanese
ono	Japanese
onoda	Japanese
onoe	Japanese
onohara	Japanese
ooka	Japanese
osagawa	Japanese
osaragi	Japanese
oshima	Japanese
oshin	Japanese
ota	Japanese
otaka	Japanese
otake	Japanese
otani	Japanese
otomo	Japanese
otsu	Japanese
otsuka	Japanese
ouchi	Japanese
oyama	Japanese
ozaki	Japanese
ozawa	Japanese
ozu	Japanese
raikatuji	Japanese
royama	Japanese
ryusaki	Japanese
sada	Japanese
saeki	Japanese
saga	Japanese
saigo	Japanese
saiki	Japanese
saionji	Japanese
saito	Japanese
saitoh	Japanese
saji	Japanese
sakagami	Japanese
sakai	Japanese
sakakibara	Japanese
sakamoto	Japanese
sakanoue	Japanese
sakata	Japanese
sakiyurai	Japanese
sakoda	Japanese
sakubara	Japanese
sakuraba	Japanese
sakurai	Japanese
sammiya	Japanese
sanda	Japanese
sanjo	Japanese
sano	Japanese
santo	Japanese
saromi	Japanese
sarumara	Japanese
sasada	Japanese
sasakawa	Japanese
sasaki	Japanese
sassa	Japanese
satake	Japanese
sato	Japanese
satoh	Japanese
satoya	Japanese
sawamatsu	Japanese
sawamura	Japanese
sayuki	Japanese
segawa	Japanese
sekigawa	Japanese
sekine	Japanese
sekozawa	Japanese
sen	Japanese
senmatsu	Japanese
seo	Japanese
serizawa	Japanese
shiba	Japanese
shibaguchi	Japanese
shibanuma	Japanese
shibasaki	Japanese
shibasawa	Japanese
shibata	Japanese
shibukji	Japanese
shichirobei	Japanese
shidehara	Japanese
shiga	Japanese
shiganori	Japanese
shige	Japanese
shigeki	Japanese
shigemitsu	Japanese
shigi	Japanese
shikitei	Japanese
shikuk	Japanese
shima	Japanese
shimada	Japanese
shimakage	Japanese
shimamura	Japanese
shimanouchi	Japanese
shimaoka	Japanese
shimazaki	Japanese
shimazu	Japanese
shimedzu	Japanese
shimizu	Japanese
shimohira	Japanese
shimon	Japanese
shimura	Japanese
shimuzu	Japanese
shinko	Japanese
shinozaki	Japanese
shinozuka	Japanese
shintaro	Japanese
shiokawa	Japanese
shiomi	Japanese
shiomiya	Japanese
shionoya	Japanese
shiotani	Japanese
shioya	Japanese
shirahata	Japanese
shirai	Japanese
shiraishi	Japanese
shirane	Japanese
shirasu	Japanese
shiratori	Japanese
shirokawa	Japanese
shiroyama	Japanese
shiskikura	Japanese
shizuma	Japanese
shobo	Japanese
shoda	Japanese
shunji	Japanese
shunsen	Japanese
siagyo	Japanese
soga	Japanese
sohda	Japanese
soho	Japanese
soma	Japanese
someya	Japanese
sone	Japanese
sonoda	Japanese
soseki	Japanese
sotomura	Japanese
suenami	Japanese
sugai	Japanese
sugase	Japanese
sugawara	Japanese
sugihara	Japanese
sugimura	Japanese
sugisata	Japanese
sugita	Japanese
sugitani	Japanese
sugiyama	Japanese
sumitimo	Japanese
sunada	Japanese
suzambo	Japanese
suzuki	Japanese
tabuchi	Japanese
tadeshi	Japanese
tagawa	Japanese
taguchi	Japanese
taira	Japanese
taka	Japanese
takabe	Japanese
takagaki	Japanese
takagawa	Japanese
takagi	Japanese
takahama	Japanese
takahashi	Japanese
takaki	Japanese
takamura	Japanese
takano	Japanese
takaoka	Japanese
takara	Japanese
takarabe	Japanese
takashi	Japanese
takashita	Japanese
takasu	Japanese
takasugi	Japanese
takayama	Japanese
takecare	Japanese
takeda	Japanese
takei	Japanese
takekawa	Japanese
takemago	Japanese
takemitsu	Japanese
takemura	Japanese
takenouchi	Japanese
takeshita	Japanese
taketomo	Japanese
takeuchi	Japanese
takewaki	Japanese
takimoto	Japanese
takishida	Japanese
takishita	Japanese
takizawa	Japanese
taku	Japanese
takudo	Japanese
takudome	Japanese
tamazaki	Japanese
tamura	Japanese
tamuro	Japanese
tanaka	Japanese
tange	Japanese
tani	Japanese
taniguchi	Japanese
tanizaki	Japanese
tankoshitsu	Japanese
tansho	Japanese
tanuma	Japanese
tarumi	Japanese
tatenaka	Japanese
tatsuko	Japanese
tatsuno	Japanese
tatsuya	Japanese
tawaraya	Japanese
tayama	Japanese
temko	Japanese
tenshin	Japanese
terada	Japanese
terajima	Japanese
terakado	Japanese
terauchi	Japanese
teshigahara	Japanese
teshima	Japanese
tochikura	Japanese
togo	Japanese
tojo	Japanese
tokaji	Japanese
tokuda	Japanese
tokudome	Japanese
tokuoka	Japanese
tomika	Japanese
tomimoto	Japanese
tomioka	Japanese
tommii	Japanese
tomonaga	Japanese
tomori	Japanese
tono	Japanese
torii	Japanese
torisei	Japanese
toru	Japanese
toshishai	Japanese
toshitala	Japanese
toshusai	Japanese
toyama	Japanese
toyoda	Japanese
toyoshima	Japanese
toyota	Japanese
toyotomi	Japanese
tsubouchi	Japanese
tsucgimoto	Japanese
tsuchie	Japanese
tsuda	Japanese
tsuji	Japanese
tsujimoto	Japanese
tsujimura	Japanese
tsukada	Japanese
tsukade	Japanese
tsukahara	Japanese
tsukamoto	Japanese
tsukatani	Japanese
tsukawaki	Japanese
tsukehara	Japanese
tsukioka	Japanese
tsumemasa	Japanese
tsumura	Japanese
tsunoda	Japanese
tsurimi	Japanese
tsuruga	Japanese
tsuruya	Japanese
tsushima	Japanese
tsutaya	Japanese
tsutomu	Japanese
uboshita	Japanese
uchida	Japanese
uchiyama	Japanese
ueda	Japanese
uehara	Japanese
uemura	Japanese
ueshima	Japanese
uesugi	Japanese
uetake	Japanese
ugaki	Japanese
ui	Japanese
ukiyo	Japanese
umari	Japanese
umehara	Japanese
umeki	Japanese
uno	Japanese
uoya	Japanese
urogataya	Japanese
usami	Japanese
ushiba	Japanese
utagawa	Japanese
wakai	Japanese
wakatsuki	Japanese
watabe	Japanese
watanabe	Japanese
watari	Japanese
watnabe	Japanese
watoga	Japanese
yakuta	Japanese
yamabe	Japanese
yamada	Japanese
yamagata	Japanese
yamaguchi	Japanese
yamaguchiya	Japanese
yamaha	Japanese
yamahata	Japanese
yamakage	Japanese
yamakawa	Japanese
yamakazi	Japanese
yamamoto	Japanese
yamamura	Japanese
yamana	Japanese
yamanaka	Japanese
yamanouchi	Japanese
yamanoue	Japanese
yamaoka	Japanese
yamashita	Japanese
yamato	Japanese
yamawaki	Japanese
yamazaki	Japanese
yamhata	Japanese
yamura	Japanese
yanagawa	Japanese
yanagi	Japanese
yanagimoto	Japanese
yanagita	Japanese
yano	Japanese
yasuda	Japanese
yasuhiro	Japanese
yasui	Japanese
yasujiro	Japanese
yasukawa	Japanese
yasutake	Japanese
yoemon	Japanese
yokokawa	Japanese
yokoyama	Japanese
yonai	Japanese
yosano	Japanese
yoshida	Japanese
yoshifumi	Japanese
yoshihara	Japanese
yoshikawa	Japanese
yoshimatsu	Japanese
yoshinobu	Japanese
yoshioka	Japanese
yoshitomi	Japanese
yoshizaki	Japanese
yoshizawa	Japanese
yuasa	Japanese
yuhara	Japanese
yunokawa	Japanese
abana	Spanish
abano	Spanish
abarca	Spanish
abaroa	Spanish
abascal	Spanish
abasolo	Spanish
abel	Spanish
abello	Spanish
aberquero	Spanish
abreu	Spanish
acosta	Spanish
agramunt	Spanish
aiza	Spanish
alamilla	Spanish
albert	Spanish
albuquerque	Spanish
aldana	Spanish
alfaro	Spanish
alvarado	Spanish
alvarez	Spanish
alves	Spanish
amador	Spanish
andreu	Spanish
antunez	Spanish
aqua	Spanish
aquino	Spanish
araujo	Spanish
araullo	Spanish
araya	Spanish
arce	Spanish
arechavaleta	Spanish
arena	Spanish
aritza	Spanish
armando	Spanish
arreola	Spanish
arriola	Spanish
asis	Spanish
asturias	Spanish
avana	Spanish
azarola	Spanish
banderas	Spanish
barros	Spanish
basurto	Spanish
bautista	Spanish
bello	Spanish
belmonte	Spanish
bengochea	Spanish
benitez	Spanish
bermudez	Spanish
blanco	Spanish
blanxart	Spanish
bolivar	Spanish
bonaventura	Spanish
bosque	Spanish
bustillo	Spanish
busto	Spanish
bustos	Spanish
cabello	Spanish
cabrera	Spanish
campo	Spanish
campos	Spanish
capello	Spanish
cardona	Spanish
caro	Spanish
casales	Spanish
castell	Spanish
castellano	Spanish
castillion	Spanish
castillo	Spanish
castro	Spanish
chavarria	Spanish
chavez	Spanish
colon	Spanish
costa	Spanish
crespo	Spanish
cruz	Spanish
cuellar	Spanish
cuevas	Spanish
dcruz	Spanish
dcruze	Spanish
delacruz	Spanish
delafuente	Spanish
delbosque	Spanish
deleon	Spanish
delgado	Spanish
delolmo	Spanish
desantigo	Spanish
diaz	Spanish
dominguez	Spanish
duarte	Spanish
durante	Spanish
echevarria	Spanish
echeverria	Spanish
elizondo	Spanish
escamilla	Spanish
escarcega	Spanish
escarra	Spanish
esparza	Spanish
espina	Spanish
espino	Spanish
espinosa	Spanish
espinoza	Spanish
estevez	Spanish
etxebarria	Spanish
etxeberria	Spanish
felix	Spanish
fernandez	Spanish
ferrer	Spanish
fierro	Spanish
flores	Spanish
fonseca	Spanish
franco	Spanish
fuentes	Spanish
gallego	Spanish
gallo	Spanish
garcia	Spanish
garrastazu	Spanish
garza	Spanish
gaspar	Spanish
gebara	Spanish
gomez	Spanish
gonzales	Spanish
gonzalez	Spanish
grec	Spanish
guadarrama	Spanish
guerra	Spanish
guerrero	Spanish
gutierrez	Spanish
hernandez	Spanish
herrera	Spanish
herrero	Spanish
hierro	Spanish
holguin	Spanish
huerta	Spanish
ibanez	Spanish
ibarra	Spanish
iniguez	Spanish
iturburua	Spanish
jaso	Spanish
jasso	Spanish
jimenez	Spanish
jorda	Spanish
juarez	Spanish
lobo	Spanish
lopez	Spanish
losa	Spanish
loyola	Spanish
machado	Spanish
macias	Spanish
maradona	Spanish
maria	Spanish
marino	Spanish
marquez	Spanish
martell	Spanish
marti	Spanish
martinez	Spanish
mas	Spanish
mata	Spanish
mateu	Spanish
medina	Spanish
melendez	Spanish
mendez	Spanish
mendoza	Spanish
menendez	Spanish
merlo	Spanish
michel	Spanish
mingo	Spanish
moles	Spanish
molina	Spanish
montero	Spanish
morales	Spanish
moralez	Spanish
moreno	Spanish
narvaez	Spanish
nieves	Spanish
noguerra	Spanish
nunez	Spanish
obando	Spanish
ochoa	Spanish
ojeda	Spanish
ola	Spanish
oleastro	Spanish
olguin	Spanish
oliver	Spanish
olmos	Spanish
oquendo	Spanish
orellana	Spanish
oriol	Spanish
ortega	Spanish
ortiz	Spanish
palomo	Spanish
paredes	Spanish
pavia	Spanish
pelaez	Spanish
pena	Spanish
perez	Spanish
petit	Spanish
picasso	Spanish
porra	Spanish
porras	Spanish
prieto	Spanish
puerta	Spanish
puga	Spanish
puig	Spanish
quinones	Spanish
quintana	Spanish
quiros	Spanish
ramirez	Spanish
ramos	Spanish
rana	Spanish
rendon	Spanish
rey	Spanish
reyes	Spanish
rios	Spanish
rivera	Spanish
rivero	Spanish
robledo	Spanish
robles	Spanish
rocha	Spanish
rodriguez	Spanish
rodriquez	Spanish
roig	Spanish
rojas	Spanish
rojo	Spanish
roldan	Spanish
roma	Spanish
romero	Spanish
rosa	Spanish
rosales	Spanish
rubio	Spanish
ruiz	Spanish
sala	Spanish
salamanca	Spanish
salazar	Spanish
salcedo	Spanish
salinas	Spanish
sanchez	Spanish
sandoval	Spanish
sannicolas	Spanish
santana	Spanish
santiago	Spanish
santillian	Spanish
santos	Spanish
sastre	Spanish
sepulveda	Spanish
sierra	Spanish
silva	Spanish
soler	Spanish
solo	Spanish
solos	Spanish
soto	Spanish
suarez	Spanish
suero	Spanish
tapia	Spanish
terrazas	Spanish
tomas	Spanish
torres	Spanish
tos	Spanish
tosell	Spanish
toset	Spanish
travieso	Spanish
trujillo	Spanish
ubina	Spanish
urbina	Spanish
urena	Spanish
valdez	Spanish
valencia	Spanish
varela	Spanish
vargas	Spanish
vasquez	Spanish
vazquez	Spanish
vega	Spanish
vela	Spanish
velazquez	Spanish
ventura	Spanish
vicario	Spanish
vilaro	Spanish
villa	Spanish
villalobos	Spanish
villanueva	Spanish
villaverde	Spanish
viola	Spanish
viteri	Spanish
vivas	Spanish
vives	Spanish
ybarra	Spanish
zabala	Spanish
zambrano	Spanish
zamorano	Spanish
zapatero	Spanish
zavala	Spanish
zubizarreta	Spanish
zuniga	Spanish
